###################
#........#........#
#*##.###.#.###.##*#
#.##.###.#.###.##.#
#.................#
#.##.#.#####.#.##.#
#....#...#...#....#
####.###.#.###.####
####.#.......#.####
####.#.## ##.#.####
   B...#| |#...A   
####.#.## ##.#.####
####.#.......#.####
####.#.#####.#.####
#........#........#
#.##.###.#.###.##.#
#*.#...........#.*#
##.#.#.#####.#.#.##
#....#...#...#....#
#.######.#.######.#
#.................#
###################